7x7:4
---
0:0:void
1:1:stone
2:1:ore
3:0:warp
---
1;1;1;1;1;1;1
1;0;0;0;0;3;1
1;0;0;0;0;0;1
1;0;0;0;0;0;1
1;0;0;0;0;2;1
1;0;0;0;2;2;1
1;1;1;1;1;1;1